# 80
2122222121122212121122221112121221121211212111112221111222212212111
3333333333333333333333333333333333333333333333333333333333333333333
3333333333333333333333333333333333333333333333333333333333333333333
3333333333333333333333333333333333333333333333333333333333333333333
3333333333333333333333333333333333333333333333333333333333333333333
3333333333333333333333333333333333333333333333333333333333333333333
3333333333333333333333333300033333333333333333333333333333333333333
3333333333333333333333333300033333333333333333333333333333333333333
3333333333333333333333333300033333333333333333333333333333333333333
3333333333333333333333333300033333333333333333333333333333333333333
3333333333333333333333333300033333333333333333333333333333333333333
3333333333333333333333333300033333333333333333333333333333333333333
3333333333333333333333333300033333330000003333333333333333333333333
3333333333333333333333333300033333330000003333333333333333333333333
3333333333333333333333333300033333330000003333333333333333333333333
3333333333333333333333333300000000000000000000000000000000000333333
3333333333333333333333333300000000000000000000000000000000000333333
3333333333333333333333333300000000000000000000000000000000000333333
3333333333333333333333333000012122210000001212122121222211112333333
3333333333333333333333333000022231320000003111233113132331313333333
3333333333333333333333333000002213210000001111323123333233213333333
3333333333333333333333333100003333330000003233232231232221223333333
3333333333333333333333333100003333330000003333323333233333333333333
3333333333333333333000000000023330000000000003333333333333333333333
3333333333333333333000000000013330000000000003333333333333333333333
3333333333333333330000000000023330000000000003333333333333333333333
3333333333333333330000021212233330000000000003333333333333333333333
3333333333333333330000012123333330000000000003333333333333333333333
3333333333333333332000003333233330000000000003333333333333333333333
3333333333333333331000003333333330000000000003333333333333333333333
3333333333333333330000003331333330000000000003333333333333333333333
3333333333333333330000013333333330000000000003333333333333333333333
3333333333333333330000023333333330000000000000000033333333333333333
3333333333333333331000000000000000000000000000000033333333333333333
3333333333333333331000000000000000000000000000000033333333333333333
3333333333333333333000000000000000000000000000000033333333333333333
3333333333333333333112000000000000000000000000000033333333333333333
3333333333333333333113000000000000000000000000000033333333333333333
3333333333333333333123000000000000000000000000000033333333333333333
3333333333333333333331220000000000000000000000000033333333333333333
3333333333333333333333220000022200000000000000000000000000033333333
3333333333333333333333330000032300000000000000000000000000033333333
3333333333333333333333110000000000000122000000000000000000033333333
3333333333333333333333330000000000000333000000000000000000033333333
3333333333333333333333331210000000000000000002112220000000033333333
3333333333333333333333333110000000000000000003123110000000033333333
3333333333333333333333332110000000000000000003313130000000033333333
3333333333333333333333332330000000000000000003223120000000033333333
3333333333333333333333333230000000000000000000000000000222233333333
3333333300000033333333333330000000000000000000000000000122133333333
3333333300000033333333300000000000000000000000000000000333233333333
33333333$0000033333333300000000000000000000000000000000333333333333
3333333311200033333333300000000000000000000001211221111333333333333
3333333311200033333330000000000000000000000003221321213333333333333
3333333312300033333330000000000002112222000003332233332333333333333
3333333333300033333330000222100002123333000003323323313333333333333
3333333300000033333330000113100000000000000002133311333333333333333
3333333300000033333330000000000000000000000003333333333333333333333
3333333300000033333330000000000000000000000000003333333333333333333
3333333300000033333331200000000000000000000000003333333333333333333
3333330000012233333332300000000000000000000000003333333333333333333
3333330000013233333333100000000000000000000000003333333333333333333
3333330000023233333333321210000000000000000000003333333333333333333
3333330000033333333333322120011200000000112000003333333333333333333
3333330000033333333333333230032100000000123000003333333333333333333
3333330000033333333333332310000000000000000000003333333333333333333
3333330000000000000000000000000000000000000001223333333333333333333
3333330000000000000000000000000000000000000003133333333333333333333
3333330000000000000000000000000000000000000003313333333333333333333
3333331111112221111122111212211221000012212211333333333333333333333
3333331123221212133212221212231333000033313313313333333333333333333
3333333221333232123233323333133232000033232133333333333333333333333
3333333333333333233333133313133333000012313233333333333333333333333
3333331331333331333332333333232333000033323333333333333333333333333
3333333333333333333333333333333333212233333333333333333333333333333
3333333333333333333333333333333333322333333333333333333333333333333
3333333333333333333333333333333333333133333333333333333333333333333
3333333333333333333333333333333333333333333333333333333333333333333
3333333333333333333333333333333333313333333333333333333333333333333
3333333333333333333333333333333333333333333333333333333333333333333
