# 59
222121111212222211221221221122111211222222222122121
333333333333333333333333333333333333333333333333333
333333333333333333333333333333333333333333333333333
333333333333333333333333333333333333333333333333333
333333333333333333333333333333333333333333333333333
333333333333333333333333333333333333333333333333333
333333333300000000000000000000033333333333333333333
333333333300000000000000000000033333333333333333333
333333333300000000000000000000033333333333333333333
333333333300000000000000000000033333333333333333333
333333333300000000000000000000033333333333333333333
333333333300000000000000000000000000000000000333333
333333333300000000000000000000000000000000000333333
333333333300000000000000000000000000000000000333333
333333333300000000000000000000000000000000000333333
333333333300000000000000000000000000000000000333333
333333333300000000000002100000000000000000000333333
333333333300000000000000000000000000000000000333333
333333000000000000012000000222221000021112211333333
333333000000000000113000000333211000022322222333333
3333330$0000000001311000000312313000022333312333333
333333121122122111133121221313320000033121313333333
333333131323213132233123313332330000033333333333333
333333313332333223333333332333330000033333333333333
333333333212333321000000000333330000003333333333333
333333333233332133000000000333331000003333333333333
333333333333333300000000000333331000003333333333333
333333333333333300000022221333333000003333333333333
333333333333333300000000000000000000013333333333333
333333333333333300000000000000000000033333333333333
333333333333333321000000000000000000013333333333333
333333333333333313000000000000000000033333333333333
333333333333333321000211121200001222133333333333333
333333333333333311000313322200003121333333333333333
333333333333333333000321123322122131333333333333333
333333333333333333000000332313122333333333333333333
333333333333333333000000333333333233333333333333333
333333333333333333000000333333333333333333333333333
333333333333333333212000333333313333333333333333333
333333333333333333312000333333333333333333333333333
333333333333333333232000333333333333333333333333333
333333333333333333331000333333333333333333333333333
333333333333333333332000333333333333333333333333333
333333333333333333333000333333333333333333333333333
333333333333333333333000333333333333333333333333333
333333333333333333333000333333333333333333333333333
333333333333333333333000333333333333333333333333333
333333333333333333333000333333333333333333333333333
333333333333333333333000333333333333333333333333333
333333333333333333333000333333333333333333333333333
333333333333333333333000333333333333333333333333333
333333333333333333333000333333333333333333333333333
333333333333333333333000333333333333333333333333333
333333333333333333333112333333333333333333333333333
333333333333333333333322333333333333333333333333333
333333333333333333333233333333333333333333333333333
333333333333333333333332333333333333333333333333333
333333333333333333333333333333333333333333333333333
333333333333333333333333333333333333333333333333333
