# 66
222112222221211222222222122212112221111121111221221
333333333333333333333333333333333333333333333333333
333333333333333333333333333333333333333333333333333
333333333333333333333333333333333333333333333333333
333333333333333333333333333333333333333333333333333
333333333333333333333333333333333333333333333333333
333333333300000000000000000000033333333333333333333
333333333300000000000000000000033333333333333333333
333333333300000000000000000000033333333333333333333
333333333300000000000000000000033333333333333333333
333333333300000000000000000000033333333333333333333
333333333300000000000000000000033333333333333333333
333333333300000000000000000000033333333333333333333
333333333300000000000000000000033333333333333333333
333333333300000000000000000000033333333333333333333
333333333300000000000000000000033333333333333333333
333333333300000000000000000000033333333333333333333
333333333300000000000000000000033333333333333333333
333333333300000000000000000000000000000000000333333
333333333300000000000000000000000000000000000333333
333333333300000000000000000000000000000000000333333
333333333300000000000000000000000000000000000333333
333333333300000000000000000000000000000000000333333
333333333300000000000000000000000000000000000333333
333333333300000000000000000000000000000000000333333
333333000000000000000000000222121000000000000333333
333333000000000001122000000131133000000000000333333
3333330$0000000001111000000321333000012122222333333
333333122122122123321122222332330000013331223333333
333333311123223133323322323333330000011332331333333
333333233331222213331122131333330000023332333333333
333333313133333333000000000333330000003332332333333
333333333333323133000000000333332000003333333333333
333333333333333300000000000333333000003333333333333
333333333333333300000022122333331000003333333333333
333333333333333300000000000000000000013333333333333
333333333333333300000000000000000000023333333333333
333333333333333311000000000000000000033333333333333
333333333333333322000000000000000000033333333333333
333333333333333313000122122200002112233333333333333
333333333333333311000233333100002212333333333333333
333333333333333333000122323311113131333333333333333
333333333333333333000000333231233333233333333333333
333333333333333333000000331323131333333333333333333
333333333333333333000000333333333333333333333333333
333333333333333333212000333333333333333333333333333
333333333333333333223000333333333333333333333333333
333333333333333333321000333333333333333333333333333
333333333333333333333000333333333333333333333333333
333333333333333333233000333333333333333333333333333
333333333333333333333000333333333333333333333333333
333333333333333333333000333333333333333333333333333
333333333333333333333000333333333333333333333333333
333333333333333333333000333333333333333333333333333
333333333333333333333000333333333333333333333333333
333333333333333333333000333333333333333333333333333
333333333333333333333000333333333333333333333333333
333333333333333333333000333333333333333333333333333
333333333333333333333000333333333333333333333333333
333333333333333333333000333333333333333333333333333
333333333333333333333112333333333333333333333333333
333333333333333333333123333333333333333333333333333
333333333333333333333313333333333333333333333333333
333333333333333333333331333333333333333333333333333
333333333333333333333333333333333333333333333333333
333333333333333333333333333333333333333333333333333
