# 70
1121121221221111112111222122212212221121222122211222112222122111222221
3333333333333333333333333333333333333333333333333333333333333333333333
3333333333333333333333333333333333333333333333333333333333333333333333
3333333333333333333333333333333333333333333333333333333333333333333333
3333333333333333333333333333333333333333333333333333333333333333333333
3333333333333333333333333333333333333333333333333333333333333333333333
3333333330003333333333333333333333333333333333333333333333333333333333
3333333330003333333333333333333333333333333333333333333333333333333333
3333333330003333333333333333333333333333333333333333333333333333333333
3333333330003333333333333333333333333333333333333333333333333333333333
3333333330003333333333333333333333333333333333333333333333333333333333
3333333330003333333333333333333333333333333333333333333333333333333333
3333333330003333333333333333333333333333333333333333333333333333333333
3333333330$03333333333333333333333333333333333333333333333333333333333
3333333330003333333333333333333333333333333333333333333333333333333333
3333333330003333333333333333333333333333333333333333333333333333333333
3333333330003333333333333333333333333333333333333333333333333333333333
3333333330003333333333333333333333333333333333333333333333333333333333
3333333330003333333333333333330000000000033333333333333333333333333333
3333333330003333333333333333330000000000033333333333333333333333333333
3333333330000000000000000000000000000000033333333333333333333333333333
3333333330000000000000000000000000000000033333333333333333333333333333
3333333330000000000000000000000000000000033333333333333333333333333333
3333333330000000000000000000000000000000033333333333333333333333333333
3333333330000000000000000000000002122100033333333333333333333333333333
3333333332222112212221112120000003223100033333333333333333333333333333
3333333332323211322232113230000001323100033333333333333333333333333333
3333333333222211233332313230000003332300033333333333333333333333333333
3333333333333113133323333111121213133100033333333333333333333333333333
3333333333332312333333332331213233333300033333333333333333333333333333
3333333333333333333333333333233323333300033333333333333333333333333333
3333333333333333333333333331323323333300033333333333333333333333333333
3333333333333333333333333333133333333300033333333333333333333333333333
3333333333333333333333333333333333333300033333333333333333333333333333
3333330000000000000000000000000000333300033333333333333333333333333333
3333330000000000000000000000000000333300033333333333333333333333333333
3333330000000000000000000000000000333300033333333333333333333333333333
3333330000000000000000000000000000003300033333333333333333333333333333
3333330000000000000000000000000000003300033333333333333333333333333333
3333330001111111100000000000000000003300033333333333333333333333333333
3333330002213232300000000000000000000000033333333333333333333333333333
3333330003223333300000222100000000000000033333333333333333333333333333
3333330002113333200000312200000000000000033333333333333333333333333333
3333330001333333300000000000000111000000033333333333333333333333333333
3333330003333333300000000000000232000000033333333333333333333333333333
3333330003333333311111211221212233000221133333333333333333333333333333
3333330003333333331331323313313333000122333333333333333333333333333333
3333330003333333321323131133331333122321333333333333333333333333333333
3333330003333333333323331333312333311311333333333333333333333333333333
3333330003333333331332133333333333313322133333333333333333333333333333
3333330003333333333333333333333333233333333333333333333333333333333333
3333330003333333333333333333333333333333333333333333333333333333333333
3333330003333333333333333333333333333333333333333333333333333333333333
3333330000000000000000000000000033333333333333333333333333333333333333
3333330000000000000000000000000000333333333333333333333333333333333333
3333330000000000000000000000000000003333333333333333333333333333333333
3333330000000000000000000000000000000033333333333333333333333333333333
3333330000000000000000000000000000000000333333333333333333333333333333
3333331212221111000001212121200000000000003333333333333333333333333333
3333333213223122000002113232222000000000000033333333333333333333333333
3333331131313131000002213233333220000000000000333333333333333333333333
3333333133333131000003323313233221200000000000000000000000000000333333
3333333333133233112123333323333232222000000000000000000000000000333333
3333333333333333112233333333333333233120000000000000000000000000333333
3333333333333333333313333333333233333322221222121221222122221211333333
3333333333333333321323333333333333312332212212331221311221131223333333
3333333333333333333313333333333333332332221323223213133113213123333333
3333333333333333333333333333333333333333131333323332132333233333333333
3333333333333333333333333333333333333333333323331333333333333333333333
3333333333333333333333333333333333333333333333333333333333333333333333
