# 30
11111111111111111111111111111111111111111111111111
11111111111111111111000000000000000000000000001111
11111111111111111111000000000000000000000000001111
11111111111111111111000111111111111111110000001111
11110000000000000511000111111111111111110000001111
11110000000000000000000111111111111111110000001111
11110000000000000000000111140000000000000000001111
11110000000000000111000111400000000000012000001111
11110001111000000111000000000000000000011200001111
11110001111000000111000000000000000000011111111111
11110000000000000000000000000000000000011111111111
11110000000000000000000000000000000000000000001111
11110000000000000000003111100000000000000000001111
11110001111100000000001111100000000000000000001111
11110001111100000010001111100000000000000000001111
11110000000000123110001000100011110000000000001111
11110000000000111110001000100011110000000000001111
11110000000000000000001000100000000000000000001111
11110000000000000000001000000000000011111100001111
11110000000000000000000000000000000011111100001111
11110000000000000000000000000000000000000000001111
11110000000000000000000000000000000000000000001111
11110000000000000000000000000000000000000000001111
11111111000000000000001111120000000000000000001111
11111111000000000000001111112000000000000000001111
11000000000000011100001111111200000000001110001111
11000000000110011100001111111120000000001110001111
11000000000000000000001111111111111100001110001111
11111111111000000000001111111111111100001110001111
11111111111111111111111111111111111111111111111111