# 20
111111111111111111111111111111
111111111111111111111111111111
111111111111111111111111111111
111100000000000000000000001111
111100000000000000000000001111
111100000000000000000000001111
111100000000000000000000001111
111100000000000000011100001111
111100000000000000011100001111
111100110000000000011100001111
111100110000000000011100001111
111100000000011100011100001111
111100000000011100011100001111
111100000000000000000000001111
111100000$00000000000000001111
111100000000000000000000001111
111111111111111111111111111111
111111111111111111111111111111
111111111111111111111111111111
111111111111111111111111111111
