# 7

111111111
100000001
100000001
100000001
100011101
100000001
111111111