# 20
331313333333333333333333133323
322313333333333333233332333322
333323333333133333132133333323
333300000000000040000000003333
331300000000000040000000003113
233300000000000040000000003233
323300000000000040000000003333
333200022220000040000000002333
131300031230000040000000002333
333300023310000040000000003331
333300033330000040000000001333
332300000330000040000000003333
333300000000000040000000003333
333300000000000040000011222323
233300000000000040000133313233
32130000$000000440002333333333
333322221222111211112333333333
331333333233331333313333131133
333333333333331323333333333333
333333323233333313333333333331
