# 16
333131333333333333333300000000000000000000000000000000000000
233333333333333333333100000000000000000000000000000000000000
333331322333333333333300000000000000000000000000000000000000
223333331333213323333300000000000000000000000000000000000000
333332332333333000000000000000000000000700000000000000000000
133333133133333000000000000000000000000000000000000000000000
233233331133333000000000000000000000000000000000000000000000
233333333333313000000007000000000000000000000000000000000000
333323213330000000000000000000000000000000000070000000000000
333333333330000000000000000000000000000000000000000000000000
332330000330000000500000000050005000500050005000500050005000
333310000000007000000000000000000000000600000000000000000000
333230000440000021111110022222122211122211212121112121211222
33333$000440000033333330031333333323333333333313332333333333
333331121122121231333320033333333332332333333323333332333333
332333233333333333233320033232133333333333331113233332133331
