# 20
331313333333333333333333133323
322313333333333333233332333322
333323333333133333132133333323
333300000000000000000000003333
331300000000000000000000003113
233300000000000000000000003233
323300000000000000000000003333
333200022220000400000000002333
131300031230000000000000002333
333300023310004000000000003331
333300033330000004000000001333
332300000330000000000000003333
333300000000000000000000003333
333300000000000400000011222323
233300000000000000000133313233
32130000$000000000002333333333
333322221222111211112333333333
331333333233331333313333131133
333333333333331323333333333333
333333323233333313333333333331
