# 31
11122111121221211212212221122212111112211221
33333333333333333333333333333333333333333333
33333333333333333333333333333333333333333333
33333333333333333333333333333333333333333333
33333333333333333333333333333333333333333333
33333333333333333333333333333333333333333333
33333333333333333333000033333333333333333333
33333333333333333300000000333333333333333333
33333333333333333000000000033333333333333333
33333333333333330000000000003333333333333333
33333333333333330000000000003333333333333333
33333333333333300000000000000333333333333333
33333333333333300000000000000333333333333333
33333333333333300000000000000333333333333333
33333333333333000000000000000033333333333333
33333333333333000000000000000033333333333333
33333333333333000000000000000033333333333333
33333333333333000000000000000033333333333333
33333333333333000000000000000033333333333333
33333333333333000000011000000033333333333333
33333333333333000000013000000033333333333333
33333333333333000220012001200033333333333333
33333300000000000000000000000000000000333333
33333300000000000000000000000000000000333333
33333300$00000000000000000000000000000333333
33333322122122211212221211212121111111333333
33333331212331221311231232233111223122333333
33333332133231321132212333111331133333333333
33333333332133333133333312332321311131333333
33333333333333332333333331333333333233333333
33333333333333333333333333333333333333333333
