# 80
2222122111212111221121112122122112221112122111212111221211121111212
3333333333333333333333333333333333333333333333333333333333333333333
3333333333333333333333333333333333333333333333333333333333333333333
3333333333333333333333333333333333333333333333333333333333333333333
3333333333333333333333333333333333333333333333333333333333333333333
3333333333333333333333333333333333333333333333333333333333333333333
3333333333333333333333333300033333333333333333333333333333333333333
3333333333333333333333333300033333333333333333333333333333333333333
3333333333333333333333333300033333333333333333333333333333333333333
3333333333333333333333333300033333333333333333333333333333333333333
3333333333333333333333333300033333333333333333333333333333333333333
3333333333333333333333333300033333333333333333333333333333333333333
3333333333333333333333333300033333330000003333333333333333333333333
3333333333333333333333333300033333330000003333333333333333333333333
3333333333333333333333333300033333330000003333333333333333333333333
3333333333333333333333333300000000000000000000000000000000000333333
3333333333333333333333333300000000000000000000000000000000000333333
3333333333333333333333333300000000000000000000000000000000000333333
3333333333333333333333333000011222120000002212112221221112212333333
3333333333333333333333333000033133310000003311121232122113213333333
3333333333333333333333333000003332330000001231332322332322113333333
3333333333333333333333333200003332330000003223231233233333333333333
3333333333333333333333333300001333230000002331333133332333333333333
3333333333333333333000000000023330000000000003333333333333333333333
3333333333333333333000000000033330000000000003333333333333333333333
3333333333333333330000000000013330000000000003333333333333333333333
3333333333333333330000021221233330000000000003333333333333333333333
3333333333333333330000033112213330000000000003333333333333333333333
3333333333333333332000003123333330000000000003333333333333333333333
3333333333333333331000002331233330000000000003333333333333333333333
3333333333333333330000002133333330000000000003333333333333333333333
3333333333333333330000013333333330000000000003333333333333333333333
3333333333333333330000023333333330000000000000000033333333333333333
3333333333333333331000000000000000000000000000000033333333333333333
3333333333333333333000000000000000000000000000000033333333333333333
3333333333333333333000000000000000000000000000000033333333333333333
3333333333333333332221000000000000000000000000000033333333333333333
3333333333333333333331000000000000000000000000000033333333333333333
3333333333333333333121000000000000000000000000000033333333333333333
3333333333333333333131120000000000000000000000000033333333333333333
3333333333333333333332130000021200000000000000000000000000033333333
3333333333333333333333330000023300000000000000000000000000033333333
3333333333333333333333330000000000000122000000000000000000033333333
3333333333333333333333320000000000000322000000000000000000033333333
3333333333333333333333331110000000000000000001112120000000033333333
3333333333333333333333333130000000000000000002323130000000033333333
3333333333333333333333331230000000000000000002311310000000033333333
3333333333333333333333333320000000000000000003133310000000033333333
3333333333333333333333331330000000000000000000000000000112133333333
3333330000033333333333333330000000000000000000000000000322133333333
3333330000033333333333300000000000000000000000000000000333333333333
33333300$0033333333333300000000000000000000000000000000321333333333
3333330000033333333333300000000000000000000001222122221333333333333
3333330000033333333330000000000000000000000003321313331333333333333
3333330000033333333330000000000002221121000002223313313333333333333
3333330000033333333330000121200003222331000001232233313333333333333
3333330000033333333330000313200000000000000003333333313333333333333
3333330000033333333330000000000000000000000003333333333333333333333
3333330000033333333330000000000000000000000000003333333333333333333
3333330000033333333332100000000000000000000000003333333333333333333
3333330000033333333333100000000000000000000000003333333333333333333
3333330000033333333331300000000000000000000000003333333333333333333
3333330000033333333333211220000000000000000000003333333333333333333
3333330000033333333333322220012200000000211000003333333333333333333
3333330000033333333333321120031300000000333000003333333333333333333
3333330000033333333333333230000000000000000000003333333333333333333
3333330000000000000000000000000000000000000002223333333333333333333
3333330000000000000000000000000000000000000002213333333333333333333
3333330000000000000000000000000000000000000001133333333333333333333
3333332221121112112221121111122212000011121111233333333333333333333
3333333332231131321133132331232111000031223123333333333333333333333
3333332313232213332233213323133223000033222313333333333333333333333
3333333331133333313333233333333333000033333233333333333333333333333
3333333333333333322333333333333333000033333323333333333333333333333
3333333333333333333333333333333333222133333333333333333333333333333
3333333333333333333333333333333333212233333333333333333333333333333
3333333333333333333333333333333333133333333333333333333333333333333
3333333333333333333333333333333333333333333333333333333333333333333
3333333333333333333333333333333333333333333333333333333333333333333
3333333333333333333333333333333333333333333333333333333333333333333
