# 73
122112122111121122122122211221
333333333333333333333333333333
333333333333333333333333333333
333333333333333333333333333333
333333333333333333333333333333
333333333333333333333333333333
333333000000000333333333333333
333333000000000333333333333333
3333330$0000000333333333333333
333333221000000333333333333333
333333113000000333333333333333
333333113000000333333333333333
333333132000221333333333333333
333333233000111333333333333333
333333333000333333333333333333
333333000000000333333333333333
333333000000000333333333333333
333333000000000333333333333333
333333000000000000333333333333
333333000000000000333333333333
333333000000000000333333333333
333333221000000000333333333333
333333123000000000333333333333
333333332000000000333333333333
333333331000000111333333333333
333333123000000111333333333333
333333333001200213333333333333
333333333001100332333333333333
333333333000000133333333333333
333333333000000333333333333333
333333333000000333333333333333
333333333000000333333333333333
333333333000000333333333333333
333333333000000333333333333333
333333333000000333333333333333
333333333000000333333333333333
333333333000000333333333333333
333333333000000333333333333333
333333333000000333333333333333
333333333000000333333333333333
333333333000000333333333333333
333333333000000333333333333333
333333333000000333333333333333
333333333000000333333333333333
333333333000000333333333333333
333333333000000333333333333333
333333333000000333333333333333
333333333000000333333333333333
333333333000000333333333333333
333333333000000333333333333333
333333333000000333333333333333
333333333000000333333333333333
333333333000000333333333333333
333333333000000333333333333333
333333333000000333333333333333
333333333000000333333333333333
333333333000000333333333333333
333333333000000333333333333333
333333333000000333333333333333
333333333000000333333333333333
333333333000000333333333333333
333333333000000333333333333333
333333333000000333333333333333
333333333000000333333333333333
333333333000000000000000333333
333333333000000000000000333333
333333333000000000000000333333
333333333221112211112121333333
333333333212132322321122333333
333333333332311211333113333333
333333333312223333333333333333
333333333323333332333233333333
333333333333333333333333333333
