# 27
1112112222121111121112122211122221112111111112
3333333333333333333333333333333333333333333333
3333333333333333333333333333333333333333333333
3333333333333333333333333333333333333333333333
3333333333333333333333333333333333333333333333
3333333333333333333333333333333333333333333333
3333333333333333333333300000000000000000333333
3333333333333333333333300000000000000000333333
3333333333333333333333300000000000000000333333
3333333333333333333000000000000000000000333333
3333333333333333333000000000000000000000333333
3333333333333333333000000000000000000000333333
3333333333333333333000000000000000000000333333
3333330000000000000000000000000000000000333333
3333330000000000000000000000000000000000333333
3333330000000000000000000000000000000222333333
3333330000000000000000000000000000000332333333
3333330000000000000000000000000000000133333333
3333330000000000000001212200000000000333333333
3333330000000000000003212300000000000333333333
3333330000$00000000003312300000000000333333333
3333331122111221212212331212221211122333333333
3333332313112133133223333311213212321333333333
3333333333233333323323333331212233333333333333
3333333221333123333233333332311323323333333333
3333333333313333333333333333323133233333333333
3333333333333333333333333333333333333333333333
